# Special countries..
REB = "countries/Rebels.txt"
PIR = "countries/Pirates.txt"
NAT = "countries/Natives.txt"

# Equus
EQS = "countries/Equestria.txt"

# North Griffonia
VED = "countries/Vedina.txt"
SKR = "countries/Skyrim.txt"
BLK = "countries/Bleakspire.txt"
VNG = "countries/Winghagen.txt"
CLD = "countries/Cloudbury.txt"
WND = "countries/Windford.txt"
BLL = "countries/Blueland.txt"
KLB = "countries/Clawbury.txt"
BRN = "countries/Brantbeak.txt"
SNC = "countries/Sunstriker.txt"
MST = "countries/Miststalker.txt"
CSB = "countries/Cursebearer.txt"
WDF = "countries/Woodfeller.txt"
SLK = "countries/Silkhorner.txt"
SKY = "countries/Skynavia.txt"
SNF = "countries/Snowflake.txt"
WHD = "countries/Whitewood.txt"
PNE = "countries/Pinegrove.txt"
ICT = "countries/Icetail.txt"
ELF = "countries/Elf_Lake.txt"
WNT = "countries/Winterhold.txt"

# Heartlands
VIN = "countries/Vinnin.txt"
INT = "countries/Interriver.txt"
KTR = "countries/Katerin.txt"
ROT = "countries/Rottendedam.txt"
FEA = "countries/Feathisia.txt"
AIW = "countries/Aiwle.txt"
LXB = "countries/Luxwingburg.txt"
REI = "countries/Reitscheid.txt"
CNA = "countries/Crona.txt"
HEL = "countries/Helheim.txt"
RDW = "countries/Readewetter.txt"
RAV = "countries/Ravensburg.txt"
CRS = "countries/Mittelfeld.txt"
KRS = "countries/Kr√§stanz.txt"
RGA = "countries/Ravensgau.txt"
OSN = "countries/Osnabeak.txt"
BEE = "countries/Beerenbeck.txt"
WIN = "countries/Winterbell.txt"
FLU = "countries/Flussschloss.txt"
STA = "countries/Starclaw.txt"
EIN = "countries/Eindlem.txt"
RMA = "countries/Romau.txt"
MID = "countries/Middenheim.txt"
GRN = "countries/Greenback.txt"
YAL = "countries/Yale.txt"
PYT = "countries/Greifenmarschen.txt"

# Aquileia
AQU = "countries/Aquileia.txt"
WST = "countries/Westtry.txt"
AET = "countries/Greifwald.txt"
HEL = "countries/Adelart.txt"
POM = "countries/Pomovarra.txt"
TAR = "countries/Tarrin.txt"
ALA = "countries/Alais.txt"
ERI = "countries/Erie.txt"
AVI = "countries/Avian.txt"
VIN = "countries/Vinovia.txt"
PRI = "countries/Pridea.txt"
RLA = "countries/Rila.txt"
VZY = "countries/Vyzima.txt"
WSK = "countries/Westkeep.txt"
FLW = "countries/Flowerino.txt"
FLO = "countries/Flowena.txt"

#Trade City Area
TRD = "countries/Skyfall.txt"
STR = "countries/Grifftonia.txt"
FZR = "countries/Fezera.txt"
VLE = "countries/Vleugeland.txt"

# Riverlands
RCT = "countries/RiverCity.txt"
LCT = "countries/LakeCity.txt"
NIM = "countries/Nimbusia.txt"
DMT = "countries/DiamondMountain.txt"

# Wingbardy
WNG = "countries/Wingbardy.txt"
FAL = "countries/Falcor.txt"
TNT = "countries/Talont.txt"
MAT = "countries/Matton.txt"